{
{0,1,1,1,0,1,1,1,1,1,1,2,1,1,1,1,1,1,1,5}
{0,0,0,1,0,1,1,1,1,1,1,6,1,1,1,1,1,2,4,2}
{0,1,1,1,0,0,0,1,0,0,1,0,0,0,0,0,0,0,1,1}
{0,1,0,0,0,0,0,1,0,0,1,0,0,0,0,0,0,0,1,1}
{0,1,1,1,1,1,1,1,0,1,1,0,1,1,1,1,1,0,1,1}
{0,1,1,1,1,1,1,0,0,0,1,1,1,1,1,1,1,0,1,1}
{0,0,0,0,0,0,0,0,0,0,0,0,0,0,0,1,1,0,1,1}
{0,0,0,0,0,0,0,0,0,0,0,0,0,0,0,1,1,0,1,1}
{1,1,1,1,4,0,1,0,1,1,1,1,1,1,1,1,1,0,1,1}
{2,1,1,0,1,0,1,0,1,1,1,1,1,1,0,0,1,0,1,1}
{1,1,0,0,1,0,1,0,1,1,1,1,1,1,0,0,1,0,1,1}
{1,2,0,0,1,0,1,0,1,1,1,1,1,1,1,0,4,0,1,1}
{1,1,0,0,1,1,1,0,1,1,1,0,1,1,1,0,1,0,2,3}
{1,1,0,0,1,0,0,0,0,0,0,0,0,0,1,1,2,1,1,1}
{1,1,0,0,1,0,0,0,0,0,0,0,0,0,1,1,1,1,1,1}
{1,1,0,0,2,6,1,1,1,1,1,1,1,2,1,1,1,1,1,1}
{1,1,0,0,6,1,1,1,1,1,1,1,1,2,1,1,1,1,1,1}
{3,3,0,0,0,0,0,0,0,0,0,0,0,0,1,1,1,1,1,1}
{1,1,0,1,1,2,1,1,1,1,1,1,1,5,1,1,1,1,1,1}
{1,2,1,1,1,1,1,1,1,1,1,1,1,5,1,1,1,1,1,1}
}
